EA ./textures/WALLDGD.png
NO ./textures/wallHD.png
SO ./textures/wallHDD.png
WE ./textures/wallHDZ.png

F 156,91,17
C 68,66,64



11111
11N001
11111


