EA ./mok.png
NO ./mok.png
SO ./mok.png
WE ./mok.png

F 102,102,0
C 102,0,255



11111
11N001
11111


