EA ./textures/brick.png
NO ./textures/WALLDGD.png
SO ./textures/wallOH.png
WE ../FINAL_CUB3D/textures/WALLok.png

F 156,91,107
C 68,66,64


11111111111111
10000000000111
11E00000000111
11111111111111


